#################################################
#           #       $                           #
#            #      $                           #
#              #    $                           #
#               #   $                           #
#                #  $                           #
#                 ########                      #
#                                               #
#                           #####  ########     #
#                                       $       #
#                     #@###$            $    ## #
#                          $            $    ## #
#                 #        $            $    ##@#
#         #      #@#       $     ###    $    ## #
#         #     #@@@#      $     #@#    $    ## #
#################################################